15
0 0 0 0 0 0 0 0 0 0 0 0 0 0 0
3 0 0 1 1 0 2 0 1 1 0 0 0 0 0
0 0 1 1 1 0 0 0 1 1 1 1 1 0 0
0 0 1 1 1 1 1 1 1 1 1 1 1 0 0
0 0 0 1 1 1 1 1 1 1 0 0 0 2 0
0 0 0 0 0 0 0 0 0 0 0 0 0 0 0
0 0 0 1 1 1 0 0 0 0 0 0 0 1 1
1 1 0 1 1 1 0 0 0 1 1 1 0 1 1
1 1 0 1 1 0 0 0 0 1 1 1 0 1 1
0 1 0 1 1 0 0 1 1 1 1 1 0 1 1
0 0 0 1 1 0 0 1 1 1 1 1 0 1 1
0 0 0 0 1 0 0 0 0 1 1 0 0 0 0
2 0 0 0 1 0 0 0 0 1 1 0 0 0 0
0 0 0 0 0 0 0 0 0 0 0 0 0 0 0
0 0 0 0 0 0 0 0 0 0 0 0 0 2 4
[[0, 1], [0, 12], [6, 1], [13, 4], [13, 14]]
[0, 1, 4, 3, 2, 0]
53.242
[[0, 1], [1, 4], [2, 6], [2, 10], [0, 12], [0, 12], [3, 13], [13, 14], [13, 14], [12, 11], [12, 5], [13, 4], [13, 4], [13, 1], [10, 0], [7, 0], [6, 1], [6, 1], [5, 0], [2, 0], [0, 1]]
8.08010220527649
