15
4
1 6
12 2
12 12
7 7
0 0 0 0 0 0 0 0 0 0 0 0 0 0 0 
0 0 0 1 1 0 2 0 1 1 0 0 0 0 0 
0 0 1 1 1 0 0 0 1 1 1 1 1 0 0 
0 0 1 1 1 1 1 1 1 1 1 1 1 0 0 
0 0 0 1 1 1 1 1 1 1 0 0 0 0 0 
0 0 0 0 0 0 0 0 0 0 0 0 0 0 0 
0 0 0 1 1 1 0 0 0 0 0 0 1 1 1 
1 1 1 1 1 1 0 2 0 1 1 1 1 1 1 
1 1 1 1 1 0 0 0 0 1 1 1 1 1 1 
0 1 1 1 1 0 0 1 1 1 1 1 1 1 1 
0 0 1 1 1 0 0 1 1 1 1 1 1 1 1 
0 0 0 0 1 0 0 0 0 1 1 0 0 0 0 
0 0 2 0 1 0 0 0 0 1 1 0 2 0 0 
0 0 0 0 0 0 0 0 0 0 0 0 0 0 0 
0 0 0 0 0 0 0 0 0 0 0 0 0 0 0 
