15
3 0 0 0 0 0 0 0 0 0 0 0 0 0 0
0 0 0 1 1 0 2 0 1 1 0 0 0 0 0
0 0 1 1 1 0 0 0 1 1 1 1 1 0 0
0 0 1 1 1 1 1 1 1 1 1 1 1 0 0
0 0 0 1 1 1 1 1 1 1 0 0 0 2 0
0 0 0 0 0 0 0 0 0 0 0 0 0 0 0
0 0 0 1 1 1 0 0 0 0 0 0 0 1 1
1 1 0 1 1 1 0 2 0 1 1 1 0 1 1
1 1 0 1 1 0 0 0 0 1 1 1 0 1 1
0 1 0 1 1 0 0 1 1 1 1 1 0 1 1
0 0 0 1 1 0 0 1 1 1 1 1 0 1 1
0 0 0 0 1 0 0 0 0 1 1 0 0 0 0
0 0 2 0 1 0 0 0 0 1 1 0 2 0 0
0 0 0 0 0 0 0 0 0 0 0 0 0 0 0
0 0 0 0 0 0 0 0 0 0 0 0 0 0 4
[[0, 0], [2, 12], [6, 1], [7, 7], [12, 12], [13, 4]]
[0, 2, 5, 3, 4, 1, 0]
58.505
[[0, 0], [5, 0], [6, 1], [6, 1], [7, 0], [10, 0], [13, 1], [13, 4], [13, 4], [8, 6], [7, 7], [7, 7], [8, 6], [12, 6], [12, 12], [12, 12], [11, 13], [3, 13], [2, 12], [2, 12], [2, 6], [0, 2], [0, 0]]
10.421611547470093
