15
3 0 0 0 0 0 0 0 0 0 0 0 0 0 0
0 0 0 1 1 0 2 0 1 1 0 0 0 0 0
0 0 1 1 1 0 0 0 1 1 1 1 1 0 0
0 0 1 1 1 1 1 1 1 1 1 1 1 0 0
0 0 0 1 1 1 1 1 1 1 0 0 0 2 0
0 0 0 0 0 0 0 0 0 0 0 0 0 0 0
0 0 0 1 1 1 0 0 0 0 0 0 0 1 1
1 1 0 1 1 1 0 2 0 1 1 1 0 1 1
1 1 0 1 1 0 0 0 0 1 1 1 0 1 1
0 1 0 1 1 0 0 1 1 1 1 1 0 1 1
0 0 0 1 1 0 0 1 1 1 1 1 0 1 1
0 0 0 0 1 0 0 0 0 1 1 0 0 0 0
0 0 2 0 1 0 0 0 0 1 1 0 2 0 0
0 0 0 0 0 0 0 0 0 0 0 0 0 0 0
0 0 0 0 0 0 0 0 0 0 0 0 0 0 4
[[0, 0], [2, 12], [6, 1], [7, 7], [12, 12], [13, 4], [0, 0]]
[0, 2, 5, 4, 1, 3, 6]
58.419
[[0, 0], [5, 0], [6, 1], [6, 1], [7, 0], [10, 0], [13, 1], [13, 4], [13, 4], [12, 5], [12, 12], [12, 12], [10, 14], [3, 13], [2, 12], [2, 12], [3, 13], [5, 13], [6, 8], [7, 7], [7, 7], [6, 5], [2, 5], [1, 4], [0, 0]]
23.919890880584717
