15
0 0 0 0 0 0 0 0 0 0 0 0 0 0 0
0 0 0 1 1 0 2 0 1 1 0 0 0 0 0
0 0 1 1 1 0 0 0 1 1 1 1 1 0 0
0 0 1 1 1 1 1 1 1 1 1 1 1 0 0
0 0 0 1 1 1 1 1 1 1 0 0 0 2 0
0 0 0 0 0 0 0 0 0 0 0 0 0 0 0
0 0 0 1 1 1 0 0 0 0 0 0 0 1 1
1 1 0 1 1 1 0 2 0 1 1 1 0 1 1
1 1 0 1 1 0 0 0 0 1 1 1 0 1 1
0 1 0 1 1 0 0 1 1 1 1 1 0 1 1
0 0 0 1 1 0 0 1 1 1 1 1 0 1 1
0 0 0 0 1 0 0 0 0 1 1 0 0 0 0
0 0 2 0 1 0 0 0 0 1 1 0 2 0 0
0 0 0 0 0 0 0 0 0 0 0 0 0 0 0
0 0 0 0 0 0 0 0 0 0 0 0 0 0 4
[[2, 12], [6, 1], [7, 7], [12, 12], [13, 4]]
[1, 4, 3, 0, 2, 1]
56.811
[[6, 1], [7, 0], [10, 0], [13, 1], [13, 4], [13, 4], [12, 5], [12, 12], [12, 12], [11, 13], [3, 13], [2, 12], [2, 12], [3, 13], [5, 13], [6, 8], [7, 7], [7, 7], [6, 5], [1, 5], [1, 1], [2, 0], [5, 0], [6, 1]]
7.404081106185913
